1111111111111111111
1000000000000011011
1000000000000011011
1000000000000011011
1PCE000000000011011
1111111111111111111