1111111111111111111
1000000000000011011
10000000D0000011011
10000000D0000011011
1PCE0000D0000011011
1111111111111111111