1111111111111111111
100000000E000011011
10000000C00C0000001
1000C00000000011011
1P0E0000E0000011011
1111111111111111111