11111111111111111111111111111111111111111111111111111111111111
100000000E0000110100000000000000000000000000000000000000000001
10000000C00C00000000000000000000000000000000000000000000000001
10000000C00C00000000000000000000000000000000000000000000000001
10000000C00C00000000000000000000000000000000000000000000000001
10000000C00C00000000000000000000000000000000000000000000000001
10000000C00C00000000000000000000000000000000000000000000000001
10000000C00C00000000000000000000000000000000000000000000000001
10000000C00C00000000000000000000000000000000000000000000000001
10000000C00C00000000000000000000000000000000000000000000000001
10000000C00C00000000000000000000000000000000000000000000000001
10000000C00C00000000000000000000000000000000000000000000000001
10000000C00C00000000000000000000000000000000000000000000000001
10000000C00C00000000000000000000000000000000000000000000000001
10000000C00C00000000000000000000000000000000000000000000000001
1000C000000000110100000000000000000000000000000000000000000001
1P0E0000E00000110100000000000000000000000000000000000000000001
11111111111111111111111111111111111111111111111111111111111111