1111111111111111111
1000000000000011011
100000000D000011011
1000C00000000011011
1P0E000000000011011
1111111111111111111