111111111111111111111111111111111111111111111111111111
100000000000000000000000000000000000000000000000011011
100000D00000000000000C00000000000000000000000000011011
110000000000000000000000000000000000000000000D00011011
1PCE000000000C0000000000000000000000000000000000011011
110000000000000000000000000000000000000000000000000001
10000000000000000000000000C000000000000000000000000001
1000000000000000000C00000000000C0000000000000000000001
100000000000000000000000000000000000000000000000000001
100000000000000000000000000000000000000000000000000001
10000000000000C000000000000000000000000000000000000001
100000000000000000100000000000010000000000000000000001
100000000000000000000000000000010000000000000000000001
100000000000000000000000000000010000000000000000000001
100000000000000001000000011110000000000000000000000001
100000000000000010000000000000000000100000000000000001
100000000000000100000000000000000000000000000000000001
100000000000000100000000000000000000000000000000000001
100000000000000100000000000000000000000000000000000001
100000000000001100000000000000000000000000000000000001
100000000000000000000000000000000000000000000000000001
100000000000000000000000111111000000000000000000000001
100000000000000000000011111111000000000000100000000001
100000000000000000000000011111111110000000000100000001
100000000000000000000000000000000000000000000000000001
100000000000000000000000000000000000000000000000000001
111111111111111111111111111111111111111111111111111111