EA ./textures/dirt.xpm
NO ./textures/wood.xpm
WE ./textures/diastone.xpm
SO ./textures/obsidian.xpm
S ./textures/sprite.xpm

C 102,204,255
F 0,153,0
R 1000 600


1111111111111111
1E00000000000001
1000000020020001111111111
1000000000000001111
1111111111111111