EA ./textures/dirt.xpm
NO ./textures/wood.xpm
WE ./textures/diastone.xpm
SO ./textures/obsidian.xpm
S ./textures/sprite.xpm

C 102,204,255
F 0,153,0
R 1000 600


11111111111
1E00000000111
11111111111
11111