EA ./textures/dirt.xpm
NO ./textures/wood.xpm
WE ./textures/diastone.xpm
SO ./textures/obsidian.xpm
S ./textures/sprite.xpm

C 230,255,100
F 220,150,190
R 1000 600



 1111111111111111111111111111111
  111111111000000000110000000001
 1111111110110000011100000000011
 100100000000000000000000002001
1111111110110000011100000002011
100000000011000001110111110201
111110110111111011100000010201111
   111110111111111011101010200001
 11100000011010101110000000020111
 100020000000000011000000002011
 100000000000000011010100002001
 110000011101010111110111000011
 11110111 1110101  10111101N001
 11111111 1111111  111111111111